# Gboard Dictionary version:2
# Gboard Dictionary format:shortcut	word	language_tag	pos_tag	
hun	aalabyss	en-AU	
arb	abokku	en-AU	
ab	abusoru	en-AU	
sam	admurai	en-AU	
arch	aeropteryx	en-AU	
hm	aflamanoir	en-AU	
gold	akwakwak	en-AU	
9	alola-form 	en-AU	
qq	alolan 	en-AU	
am	amagara	en-AU	
arm	amarudo	en-AU	
ncc	amassel	en-AU	
oma	amonistar	en-AU	
om	amonitas	en-AU	
fg	amphizel	en-AU	
bl	ampibidou	en-AU	
grim	angoliath	en-AU	
ano	anopth	en-AU	
cm	apitrini	en-AU	
jel	apoquallyp	en-AU	
dt	arboretoss	en-AU	
god	arceus 	en-AU	
bro	archéomire	en-AU	
ava	arktilas	en-AU	
art	artikodin	en-AU	
up	axoloto	en-AU	
aze	azelf	en-AU	
sb	bacabouh	en-AU	
thw	badabouin	en-AU	
scr	baggiguane	en-AU	
qa	bailonda	en-AU	
cam	bakuuda	en-AU	
cti	balbaleze	en-AU	
qw	baldorfish	en-AU	
sp	baneboo	en-AU	
gou	banshitrouye	en-AU	
barr	barrakiefa	en-AU	
bas	barschuft	en-AU	
fe	barschwa	en-AU	
dri	baudrive	en-AU	
tou	bazoucan	en-AU	
pel	bekipan	en-AU	
ark	bergmite	en-AU	
sle	betbeter	en-AU	
vo	biriridama	en-AU	
blac	blacephalon	en-AU	
coo	bleuseille	en-AU	
cas	blindalys	en-AU	
flo	bojelin	en-AU	
abu	bombydou	en-AU	
fla	booster	en-AU	
agg	bossgodora	en-AU	
tang	bouldeneu	en-AU	
baku	boumata	en-AU	
muds	bourrinos	en-AU	
fff	braisillon	en-AU	
sei	branawarz	en-AU	
ches	brigaron	en-AU	
row	brindibou	en-AU	
dcb	briochien	en-AU	
pinc	britzigel	en-AU	
gig	brockoloss	en-AU	
sct	brullschweif	en-AU	
sal	brutalanda	en-AU	
mgm	buba	en-AU	
spo	bubungus	en-AU	
b	buby	en-AU	
bu	bulu	en-AU	
sl	bummelz	en-AU	
bui	buoysel	en-AU	
wor	burmadame	en-AU	
blaz	bursyamo	en-AU	
buz	buzzwole	en-AU	
skd	cabriolaine	en-AU	
deli	cadoizo	en-AU	
mala	calamanero	en-AU	
cal	calyrex	en-AU	
wi	camome	en-AU	
frf	canarticho 	en-AU	
cn	caninos	en-AU	
amb	capidextre	en-AU	
ai	capumain	en-AU	
war	carabaffe	en-AU	
lau	carabing	en-AU	
ggg	carchacrok	en-AU	
amg	carmadura	en-AU	
aa	casey	en-AU	
bib	castorno	en-AU	
esc	cavalanzas	en-AU	
cel	celebi	en-AU	
cele	celesteela	en-AU	
sco	cerapendra	en-AU	
wyr	cerbyllin	en-AU	
ch	ceriflor	en-AU	
pur	chacripan	en-AU	
num	chamallot	en-AU	
bre	chapignon	en-AU	
cha	charbambin	en-AU	
medi	charem	en-AU	
cu	charibari	en-AU	
trt	chelterrar	en-AU	
rau	chenipan	en-AU	
wu	chenipotte	en-AU	
ki	cherinbo	en-AU	
gog	chevrumm	en-AU	
chy	chi-yu	en-AU	
chik	chicorita	en-AU	
chp	chien-pao	en-AU	
cpp	chilingel	en-AU	
cnc	chillaccino	en-AU	
mon	chimpenfeu	en-AU	
min	chinchidou	en-AU	
pet	chlorobule	en-AU	
fue	chochodile	en-AU	
lam	chonchie	en-AU	
oo	choreogel	en-AU	
woo	chovsourir	en-AU	
ak	chrysapile	en-AU	
gn	chuchmur 	en-AU	
ha	cizayox	en-AU	
kkk	cliticlic	en-AU	
pil	cochignon	en-AU	
kak	coconfort	en-AU	
qx	coiffeton	en-AU	
cra	colhomard	en-AU	
sli	colimucus	en-AU	
tq	colombeau	en-AU	
palo	colossand	en-AU	
pri	colossinge	en-AU	
tnd	compagnol	en-AU	
guf	concombaffe	en-AU	
pe	coquiperl	en-AU	
cooo	corvaillus	en-AU	
cosm	cosmoem	en-AU	
cos	cosmog	en-AU	
tor	cotoise	en-AU	
fur	couafarel	en-AU	
aw	coupenotte	en-AU	
ann	courrousinge	en-AU	
ku	couverdure	en-AU	
kx	crabagarre	en-AU	
cru	crabaraque	en-AU	
db	crabicoque	en-AU	
kw	crabominable	en-AU	
kf	craparoi	en-AU	
cre	crecelia	en-AU	
dru	crimgan	en-AU	
crl	crocalor	en-AU	
aj	croquine	en-AU	
clo	crustabri	en-AU	
acb	cryospino 	en-AU	
slu	cupcanaille	en-AU	
cff	curelei	en-AU	
stan	damhirplex	en-AU	
spea	dardargnan	en-AU	
dar	darkrai	en-AU	
daru	darumarond	en-AU	
tyr	debugant	en-AU	
ded	dedenne	en-AU	
vz	delestin	en-AU	
pf	delfinator	en-AU	
dx	delphox	en-AU	
bru	denticrisse	en-AU	
deo	deoxys	en-AU	
garb	deponitox	en-AU	
tyra	despotar	en-AU	
dia	dialga	en-AU	
dian	diancie	en-AU	
zw	dihead	en-AU	
dk	dimoclès	en-AU	
dn	dipplin	en-AU	
drak	dispareptil	en-AU	
do	dodo	en-AU	
km	dodoala	en-AU	
dod	dodorio	en-AU	
lou	dogohmb	en-AU	
bron	dohtakun	en-AU	
dus	dokucale	en-AU	
ten	dokukurage	en-AU	
vik	donarion	en-AU	
donp	donfan	en-AU	
honc	donkarasu	en-AU	
rm	donnersichel	en-AU	
dp	dorameshiya	en-AU	
cot	doudouvet	en-AU	
shel	drackhaus	en-AU	
ddd	dracolosse	en-AU	
aur	dragmara	en-AU	
drif	drifzepeli	en-AU	
dud	dudunsparce 	en-AU	
bel	dumbber	en-AU	
sad	dunaconda 	en-AU	
aeg	durengard	en-AU	
pid	dusselgurr	en-AU	
chann	ebiwalar	en-AU	
gen	ectoplasma	en-AU	
se	efoserp	en-AU	
ee	eievui	en-AU	
ill	eisenblatt	en-AU	
ib	eisenbundel	en-AU	
itt	eisendorn	en-AU	
imm	eisenfalter	en-AU	
ibb	eisenfels	en-AU	
ij	eisenhals	en-AU	
ih	eisenhand	en-AU	
ic	eisenhaupt	en-AU	
iva	eisenkrieger	en-AU	
it	eisenrad	en-AU	
ele	eleboo	en-AU	
elec	elevoltek	en-AU	
shi	elezeba	en-AU	
yg	embrylex 	en-AU	
em	emonga	en-AU	
emp	emperte	en-AU	
vic	empiflor	en-AU	
ena	enamorus	en-AU	
sk	eneco	en-AU	
delc	enekororo	en-AU	
ent	entei	en-AU	
kid	erekiddo	en-AU	
ep	espathra	en-AU	
bxc	espinodon	en-AU	
digg	excavarenne	en-AU	
lic	excelangue	en-AU	
gh	fantominus	en-AU	
elf	farfaduvet	en-AU	
sne	farfuret	en-AU	
un	fasasnob	en-AU	
sin	fatalitee	en-AU	
ort	ferdeter	en-AU	
pig	ferkokel	en-AU	
veg	feuillajou	en-AU	
sms	feuiloutan	en-AU	
f	feunnec	en-AU	
fz	fezandipiti	en-AU	
spd	filentrappe	en-AU	
glal	firnontor	en-AU	
broo	flagadoss	en-AU	
gril	flamajou	en-AU	
hp	flambino	en-AU	
emb	flambirex	en-AU	
fia	flambusard	en-AU	
l	flamiaou	en-AU	
ske	flamigator	en-AU	
fm	flaminkno	en-AU	
grill	flamoutan	en-AU	
smr	flamoutan 	en-AU	
darm	flampivian	en-AU	
arc	flapteryx	en-AU	
swi	flauschling	en-AU	
ac	flemmli	en-AU	
clau	flingouste	en-AU	
flr	floragato 	en-AU	
lur	floramantis	en-AU	
sod	flotajou	en-AU	
smp	flotoutan	en-AU	
flm	flotte-meche	en-AU	
ig	fluffeluff	en-AU	
fi	fluvetin 	en-AU	
lea	folipurba	en-AU	
brb	fongus-furie	en-AU	
tk	forgerette	en-AU	
for	forstellka	en-AU	
ot	fouinette	en-AU	
lg	fragilady	en-AU	
oi	fragroin	en-AU	
hd	friedwuff	en-AU	
j	frissonille 	en-AU	
rak	frizelbliz 	en-AU	
fri	frospino	en-AU	
wis	froussardine	en-AU	
can	frubaila	en-AU	
gfi	fue-percant	en-AU	
inc	fuegro	en-AU	
g	fukamaru	en-AU	
kwt	fulgulairo	en-AU	
fl	furabebe	en-AU	
floe	furaette	en-AU	
flor	furajesu	en-AU	
rgb	furienblitz	en-AU	
venu	fushigibana 	en-AU	
bs	fushigidane 	en-AU	
url	gachiguma	en-AU	
gal	galagladi	en-AU	
tir	galapaflos	en-AU	
qqq	galarian 	en-AU	
gp	galopa	en-AU	
eg	galvaran	en-AU	
claw	gamblast	en-AU	
snd	ganovil 	en-AU		
hid	garstella	en-AU	
tr	geckarbor	en-AU	
sur	gehweiher	en-AU	
van	gelatini	en-AU	
vani	gelatroppo	en-AU	
gene	genesect	en-AU	
gra	georok	en-AU	
nc	geosali	en-AU	
gole	geowaz	en-AU	
ruf	geronimatz	en-AU	
sce	gewaldro	en-AU	
k	giaru	en-AU	
gim	gierspenst	en-AU	
gi	giratina	en-AU	
paw	gladiantri	en-AU	
kg	gladimperio	en-AU	
reli	glanth	en-AU	
glas	glastrier	en-AU	
gla	glaziola	en-AU	
croa	glibunkel	en-AU	
cg	glibunkel 	en-AU	
golu	golemastoc	en-AU	
ph	gomazou	en-AU	
rill	gorythmic	en-AU	
rok	goupix	en-AU	
le	gourmelet	en-AU	
s	grainipiot	en-AU	
gran	granbulu	en-AU	
3	grandiras	en-AU	
tkn	granforgita	en-AU	
grav	gravalanch	en-AU	
fk	grenousse	en-AU	
sr	gribouraigne	en-AU	
sz	grillepattes	en-AU	
imp	grimalin	en-AU	
gt	gringolem	en-AU	
msf	grondogue	en-AU	
grum	groret	en-AU	
u	grotadmorv	en-AU	
gro	groudon 	en-AU	
tep	gruikui	en-AU	
grd	guardevoir 	en-AU	
guz	guzzlord	en-AU	
gy	gyarados	en-AU	
sev	habunake	en-AU	
klv	hachecateur	en-AU	
stee	haganeil	en-AU	
dd	hakuryu	en-AU	
scv	halupenjo	en-AU	
har	hariteyama	en-AU	
lom	hasubrero	en-AU	
grot	hayashigame	en-AU	
hea	heatran	en-AU	
dnd	heerashai	en-AU	
iv	herbizarre 	en-AU	
fal	hexadron	en-AU	
cry	hexagel	en-AU	
ted	himeguma	en-AU	
cy	hinoarashi	en-AU	
hi	hipopotasu	en-AU	
ft	hirahina	en-AU	
hsa	hisuian arcanine	en-AU	
hav	hisuian avalugg	en-AU	
hb	hisuian braviary	en-AU	
hse	hisuian electrode 	en-AU	
hgg	hisuian goodra	en-AU	
hgw	hisuian growlithe	en-AU	
hsga	hisuian growlithe 	en-AU	
hl	hisuian lilligant 	en-AU	
hq	hisuian qwilfish	en-AU	
hsg	hisuian sliggoo 	en-AU	
hss	hisuian sneasel 	en-AU	
ht	hisuian typhlosion 	en-AU	
hv	hisuian voltorb 	en-AU	
hzz	hisuian zoroark	en-AU	
hz	hisuian zorua 	en-AU	
sta	hitodeman	en-AU	
char	hitokage	en-AU	
glu	hitokage 	en-AU	
lit	hitomoshi	en-AU	
wai	hoeruko 	en-AU	
ves	honweisel	en-AU	
hoo	hoopa	en-AU	
ho	hoothoot	en-AU	
hop	hoppspross	en-AU	
bee	hornliu	en-AU	
bd	hornliu	en-AU	
oh	houou	en-AU	
ski	hubelupf	en-AU	
ston	humanolith	en-AU	
hell	hundemon 	en-AU	
del	hunduster	en-AU	
amo	hutsassa	en-AU	
hdp	hydrapple	en-AU	
hy	hypnomade	en-AU	
goth	hypnomorba	en-AU	
ta	hypotrempe	en-AU	
uno	icognito	en-AU	
che	igamaro	en-AU	
qui	igastarnish	en-AU	
ord	impergator	en-AU	
dun	insolourdo	en-AU	
scra	irokex	en-AU	
web	itomaru	en-AU	
o	iwark	en-AU	
jib	jibacoil	en-AU	
zig	jiguzaguma	en-AU	
ji	jirachi	en-AU	
th	judokrak	en-AU	
ban	juppeta	en-AU	
dura	jurarudon	en-AU	
hip	kabarudon	en-AU	
kab	kabuto	en-AU	
kabu	kabutopusu	en-AU	
pyr	kaenjinshi	en-AU	
dre	kajirigame	en-AU	
ap	kajitchu	en-AU	
kec	kakureon	en-AU	
cw	kamukame	en-AU	
kang	kangourex	en-AU	
ca	kanivanha	en-AU	
top	kapoerer	en-AU	
lud	kappalores	en-AU	
dei	kapuno	en-AU	
ww	karadonis	en-AU	
sll	karanakushi 	en-AU	
sil	karasalis	en-AU	
carr	karippas	en-AU	
tot	karnimani	en-AU	
ko	karpador	en-AU	
kart	kartana	en-AU	
gri	kastadur	en-AU	
fin	keikouo	en-AU	
kd	keldeo	en-AU	
tau	kentauros	en-AU	
dot	keradar	en-AU	
bi	keunotor	en-AU	
sunf	kimawari	en-AU	
bag	kindwurm	en-AU	
kn	kinococo	en-AU	
bello	kireihana	en-AU	
gir	kirinriki	en-AU	
kir	kirlia	en-AU	
lie	kleoparda	en-AU	
nic	kleptifux	en-AU	
kk	kliklak	en-AU	
chin	klingplim	en-AU	
rol	klonkett 	en-AU	
cp	klopptopus	en-AU	
tra	knacklion	en-AU	
gg	knarksel	en-AU	
vr	knattox	en-AU	
sc	kofukimushi	en-AU	
pm	kofukimushi 	en-AU	
she	kokiyas	en-AU	
ora	kommandutan	en-AU	
ven	kongpang	en-AU	
nuz	konohana	en-AU	
kod	koraidon 	en-AU	
kri	korobohshi	en-AU	
be	kosturso	en-AU	
kin	krabboss	en-AU	
dg	kravarech	en-AU	
sww	krawalloro	en-AU	
ex	krawumms	en-AU	
hei	krebscorps 	en-AU	
slw	kriechflugel	en-AU	
saw	kronjuwild	en-AU	
spi	kryppuk		en-AU	
kub	kubfu		en-AU	
eis	kubuin		en-AU	
wat	kukmarda	en-AU	
mf	kungfouine	en-AU	
pine	kunugidama 	en-AU	
kr	kurabu		en-AU	
gl	kusaihana	en-AU	
ky	kyogre		en-AU	
swm	laggron		en-AU	
flaa	lainergie	en-AU	
jug	lamantine	en-AU	
shii	lampignon	en-AU	
land	landorus 	en-AU	
dpp	lanssorien	en-AU	
drag	lanssorien	en-AU	
lan	lantern		en-AU	
bun	laporeille	en-AU	
sew	larveyette	en-AU	
mab	larvibule	en-AU	
lat	latias		en-AU	
lati	latios		en-AU	
sir	lauchzelot	en-AU	
mol	lavados		en-AU		
rl	leboulerou	en-AU	
el	lektrobal	en-AU	
cl	lepumentas	en-AU	
bom	lestombaile	en-AU	
sla	letarking	en-AU	
milk	leuphorie	en-AU	
luc	leveinard	en-AU	
lk	lextremo	en-AU	
int	lezargus	en-AU	
fly	libelldra	en-AU	
lov	liebiskus	en-AU	
nm	lilliterelle	en-AU	
lil	lilyla	en-AU	
jy	lippoutou	en-AU	
li	lizardo	en-AU	
liz	lizardon	en-AU	
lop	lockpin	en-AU	
la	lokhlass	en-AU	
lo	loturzel	en-AU	
lu	lugia	en-AU	
chan	lugulabre	en-AU	
gmm	lumiflora	en-AU	
gm	lumispross	en-AU	
il	lumivole	en-AU	
luna	lunala	en-AU	
lun	lunastein	en-AU	
mac	machollo	en-AU	
mc	machollo 	en-AU	
choke	machopeur	en-AU	
mcc	machopeur 	en-AU	
champ	mackogneur	en-AU	
mccc	mackogneur 	en-AU	
bay	macronium	en-AU	
maa	madatsubomi 	en-AU	
boob	magbrant	en-AU	
mage	magearna	en-AU	
qu	magmarashi 	en-AU	
mig	magnayen	en-AU	
co	magnetilo	en-AU	
alc	mahoippu	en-AU	
mil	mahomiru	en-AU	
ser	majaspic	en-AU	
ya	makabaja	en-AU	
mak	makunoshita	en-AU	
salaz	malamandre	en-AU	
ce	malvalame	en-AU	
alo	mamanbo	en-AU	
mam	mammochon	en-AU	
ml	mampfaxo	en-AU	
mana	manaphy	en-AU	
yun	manglouton	en-AU	
zan	mangriff	en-AU	
gum	manguspektor	en-AU	
man	mantain	en-AU	
leav	manternel	en-AU	
mt	mantirps	en-AU	
mara	maracamba	en-AU	
bri	marikeck	en-AU	
ma	maril	en-AU	
azu	marilli	en-AU	
or	maritellit	en-AU	
md	marshadow	en-AU	
mas	maskeregen	en-AU	
lin	massuguma	en-AU	
mbs	mastifioso	en-AU	
moo	mastouffe	en-AU	
smo	matadogas	en-AU	
mss	maushold	en-AU	
palp	mebrana	en-AU	
2	mediras	en-AU	
asa	meditie	en-AU	
meg	meganie	en-AU	
yanm	megayanma	en-AU	
con	meistagrif	en-AU	
melt	meltan	en-AU	
so	memmeon	en-AU	
men	menki	en-AU	
te	menokurage	en-AU	
es	mentali	en-AU	
melm	merumetaru	en-AU	
mes	mesprit	en-AU	
meta	metagurosu	en-AU	
di	metamon	en-AU	
met	metangu	en-AU	
mini	meteno	en-AU	
m	mew	en-AU	
mm	mewtwo	en-AU	
tru	miamiasme	en-AU	
mau	miaouss	en-AU	
mew	miascarade	en-AU	
h	miburimu	en-AU	
ny	miezunder	en-AU	
aria	migalos	en-AU	
milo	milokaross	en-AU	
im	mimantis	en-AU	
y	mimigma	en-AU	
d	minidraco	en-AU	
1	miniras	en-AU	
jang	miniras	en-AU	
roo	minisange	en-AU	
bur	minomucchi	en-AU	
mod	miraidon	en-AU	
duo	mitodos	en-AU	
mud	mizugorou	en-AU	
go	mollimorba	en-AU	
sala	molunk	en-AU	
tyran	monargoras	en-AU	
ghl	monetigo	en-AU	
hn	monorpale	en-AU	
uni	monozyto	en-AU	
coa	monthracite	en-AU	
mars	moorabbel	en-AU	
gothi	morbitesse	en-AU	
nu	morlord	en-AU	
ve	morphon	en-AU	
mp	morupeko	en-AU	
rot	motisma	en-AU	
cyl	motorizard	en-AU	
fro	mottineva	en-AU	
sku	moufflair	en-AU	
stun	moufouette	en-AU	
dub	moumouflon	en-AU	
wl	moumouton	en-AU	
os	moustillon	en-AU	
smoo	muchul	en-AU	
vol	muciole	en-AU	
goo	mucuscule	en-AU	
et	mugendaina	en-AU	
mk	mukubird	en-AU	
stp	mukuhawk	en-AU	
mki	munkidori	en-AU	
gud	muplodocus	en-AU	
galv	mygavolt	en-AU	
maw	mysdibule	en-AU	
od	mystherbe	en-AU	
lp	mélancolux	en-AU	
umb	nachtara	en-AU	
pat	nagelotz	en-AU	
whis	namazun	en-AU	
no	nasgnet	en-AU	
x	natio	en-AU	
n	naty	en-AU	
ne	necrozma	en-AU	
mn	negapi	en-AU	
ohb	neitram	en-AU	
lum	neoranto	en-AU	
king 	nidoking	en-AU	
quee	nidoqueen 	en-AU	
nid	nidoran	en-AU	
rina	nidorina	en-AU	
rino	nidorino	en-AU	
tat	nigirigon	en-AU	
uu	nigosier	en-AU	
ni	nihilego	en-AU	
mu	ninjatom	en-AU	
exe	noadkoko	en-AU	
um	noctali	en-AU	
da	nodulithe	en-AU	
ow	noeunoeuf	en-AU	
cac	noktuska	en-AU	
fn	normifin	en-AU	
gb	nosferalto	en-AU	
zu	nosferapti	en-AU	
cr	nostenfer	en-AU	
sf	nounourson	en-AU	
perr	nyaikingu	en-AU	
glam	nyarmar	en-AU	
sy	nymphali	en-AU	
polll	nyorobon	en-AU
poli	nyorotono	en-AU	
op	ogerpon		en-AU	
run	oghnatoll	en-AU	
eele	ohmassacre	en-AU	
aud	ohrdoch	en-AU	
oc	okutank	en-AU	
abl	olithena	en-AU	
dl	olivado	en-AU	
sml	olivini	en-AU	
fx	onondo	en-AU	
bin	opermine	en-AU	
prim	oratoria	en-AU	
maro	ossatueur	en-AU	
pop	otaquin	en-AU	
grap	otosupasu	en-AU	
groo	ouistempo	en-AU	
cc	ouisticram	en-AU	
gur	ouvrifier	en-AU	
p	pachirisu	en-AU	
cop	pachyradjah	en-AU	
chim	palimpalim	en-AU	
pal	palkia	en-AU	
pan	pam-pam	en-AU	
p2	pamamo	en-AU	
p3	pamomamo	en-AU	
pang	pandarbare	en-AU	
mrr	pantifrost 	en-AU	
jr	pantimimi	en-AU	
mr	pantimos	en-AU	
ska	panzaeron	en-AU	
mot	papilord	en-AU	
age	papinella	en-AU	
jum	papungha	en-AU	
bo	paragoni	en-AU	
para	parasekuto	en-AU	
par	parasu	en-AU	
coc	parfinesse	en-AU	
bolt	parusuwan	en-AU	
ff	passerouge	en-AU	
fd	patachiot	en-AU	
pa	patcheel	en-AU	
az	patchirudon	en-AU	
e	pawou	en-AU	
put	pecharunt 	en-AU	
ssc	pelage-sable	en-AU	
mor	pelzebub	en-AU	
amp	pharamp	en-AU	
phe	pheromosa 	en-AU	
phi	phione	en-AU	
dr	phlegleon	en-AU	
hab	piafabec	en-AU	
pi	picassaut	en-AU	
duc	piccolente	en-AU	
pp	pichū	en-AU	
trum	piclairon	en-AU	
ctd	pietace	en-AU	
c	pii	en-AU	
pik	pikachū	en-AU	
dra	piondragi	en-AU	
rap	pionskora	en-AU	
cle	pippi	en-AU	
irr	pitrouille	en-AU	
chat	plaudagei	en-AU	
fif	pochiena	en-AU	
p1	pohm	en-AU	
poi	poipole	en-AU	
seak	poissoroy	en-AU	
bea	polagriffe	en-AU	
cbc	polarhume	en-AU	
shup	polichombr	en-AU	
fp	pomdrapi	en-AU	
ach	pondralugon	en-AU	
pon	ponita	en-AU	
por	porygon	en-AU	
pw	porygon2	en-AU	
pz	porygonz	en-AU	
pl	posipi	en-AU	
prin	pottaishi	en-AU	
polt	pottodesu	en-AU	
spr	poussacha	en-AU	
torc	poussifeu	en-AU	
cast	powalen	en-AU	
ti	praktibalk	en-AU	
viv	prismillon	en-AU	
meo	psiaugon	en-AU	
en	psykokwak	en-AU	
esp	psystigri	en-AU	
pt	ptera	en-AU	
pol	ptitard	en-AU	
tyt	ptyranidur	en-AU	
wig	pukurin	en-AU	
bal	puppance	en-AU	
lew	pygraulon	en-AU	
cin	pyrobut	en-AU	
ign	pyronille	en-AU	
gr	quajutsu	en-AU	
poll	quaputzi	en-AU	
pww	quaputzi	en-AU	
pass	quartermak	en-AU	
qxx	quaxwell 	en-AU	
sw	quiekel	en-AU	
oq	qwilpik	en-AU	
rab	rabifutto	en-AU	
kroo	rabigator	en-AU	
ge	racaillou	en-AU	
ra	raikou	en-AU	
ram	rameidon	en-AU	
yad	ramoloss	en-AU	
fea	rapasdepic	en-AU	
kor	rattfratz	en-AU	
rat	rattikarl	en-AU	
ray	rayquaza 	en-AU	
rar	reakoiru	en-AU	
cx	rediba 	en-AU	
reg	regice	en-AU	
regd	regidrago	en-AU	
regi	regieleki	en-AU	
rr	regirock	en-AU	
regis	registeel	en-AU	
lx	rentorar	en-AU	
gv	reptain	en-AU	
res	reshiram	en-AU	
haw	resladero	en-AU	
ao	rettan	en-AU	
rvr	revavroom 	en-AU	
abo	rexblisar	en-AU	
rh	rhinocorne	en-AU	
swo	rhinolove	en-AU	
gtu	riesenzahn	en-AU	
rhy	rihornior	en-AU	
fa	rikikirin	en-AU	
ur	ringuma	en-AU	
ri	rioru	en-AU	
don	rizeros	en-AU	
iw	rocabot 	en-AU	
kro	rokkaiman	en-AU	
pu	rondoudou	en-AU	
rel	ronflex	en-AU	
skw	rongourmand	en-AU	
dril	rototaupe	en-AU	
thi	roublenard	en-AU	
pg	roucarnage	en-AU	
pd	roucoups	en-AU	
bx	roussil	en-AU	
bud	rozbouton	en-AU	
ro	rozeria	en-AU	
ros	rozureido	en-AU	
rib	rubombelle	en-AU	
vil	ruffresia	en-AU	
lc	rukario	en-AU	
lux	rukushio	en-AU	
ludi	runpappa	en-AU	
sa	sabelette	en-AU	
san	sablaireau	en-AU	
tus	sabonea	en-AU	
sanda	sadaija	en-AU	
pod	safcon	en-AU	
gor	sakurabyss	en-AU	
toxt	salarsen	en-AU	
bsc	salmagnis	en-AU	
ga	saltigant	en-AU	
sha	samehader	en-AU	
bb	sapereau	en-AU	
tan	saquedeneu	en-AU	
goli	sarmuraï	en-AU	
arr	sashikamasu	en-AU	
bg	satchimushi 	en-AU	
bp	satchimushi 	en-AU	
lee	sawamular	en-AU	
bsh	scalproie	en-AU	
pin	scarabrute	en-AU	
tm	schallquap 	en-AU	
sd	schilterus	en-AU	
loc	schlapor	en-AU	
lot	schlukwech	en-AU	
gu	schluppuck	en-AU	
lick	schlurplek	en-AU	
barb	schmerbe	en-AU	
mag	schneckmag	en-AU	
shm	schnuthelm	en-AU	
su	schwalbini	en-AU	
tai	schwalboss	en-AU	
swe	schwalboss	en-AU	
roll	scobolide	en-AU	
cent	scolocendre	en-AU	
gli	scorplane	en-AU	
bol	sedimantur	en-AU	
sea	seemon	en-AU	
dram	sen-long	en-AU	
i	sepiatop	en-AU	
wwl	serpente-eau	en-AU	
sni	serpifeu	en-AU	
q	shadow 	en-AU	
ms	shaofouine	en-AU	
shay	shaymin	en-AU	
ss	sheinux	en-AU	
tn	shibishirasu 	en-AU	
ll	shishiko	en-AU	
craw	shizariger	en-AU	
dew	shizukumo	en-AU	
puru	shnurgarst	en-AU	
vap	showers 	en-AU	
str	sichlor	en-AU	
hor	sihorn	en-AU	
silv	silvally	en-AU	
dec	silvarro	en-AU	
inf	simiabraz	en-AU	
ala	simsala	en-AU	
sud	simularbre	en-AU	
snt	sinistcha	en-AU	
dhel	sinistrail	en-AU	
rb	skarabaks	en-AU	
her	skaraborn	en-AU	
glis	skorgro	en-AU	
butt	smettbo	en-AU	
sm	smogon	en-AU	
wea	snibunna	en-AU	
snl	snieboss	en-AU	
per	snobilikat	en-AU	
is	sohnano	en-AU	
solg	solgaleo	en-AU	
mun	somniam	en-AU	
mush	somnivora	en-AU	
on	sonistrelle	en-AU	
vanil	sorbouboul	en-AU	
hhh	sorcilence	en-AU	
wim	sovkipou	en-AU	
spe	spectrier	en-AU	
hau	spectrum	en-AU	
exc	stalobor	en-AU	
st	staralili	en-AU	
star	staross	en-AU	
lai	stollrak	en-AU	
a	stollunior	en-AU	
cb	strassie	en-AU	
ts	sucreine	en-AU	
si	sunahebi	en-AU	
cor	sunnygo	en-AU	
swa	swaroness	en-AU	
sig	symvolara	en-AU	
ob	tachifusaguma	en-AU	
tf	tafforgita	en-AU	
gf	taginguru	en-AU	
oba	tamazarashi	en-AU	
bulu	tapu bulu	en-AU	
fini	tapu fini	en-AU	
koko	tapu koko	en-AU	
lele	tapu lele	en-AU	
ara	tarenbulle	en-AU	
pwr	tartard	en-AU	
app	taruppuru	en-AU	
po	taubsi	en-AU	
wg	taupikeau	en-AU	
dig	taupiqueur	en-AU	
hh	teburimu	en-AU	
nj	tekkanin	en-AU	
sh	tengulist	en-AU	
tc	tentagra	en-AU	
nut	tentantel	en-AU	
tcc	tenterra	en-AU	
rem	teppouo	en-AU	
cld	terraiste	en-AU	
herd	terribark	en-AU	
td	tetampoule	en-AU	
bar	thanathora	en-AU	
jolt	thunders	en-AU	
thu	thundurus	en-AU	
mudb	tiboudet	en-AU	
tl	ting-lu	en-AU	
pip	tiplouf	en-AU	
tar	tissenboule	en-AU	
leo	todoggler	en-AU	
wal	todoseruga	en-AU	
tt	togechick	en-AU	
tog	togedemaru 	en-AU	
ttt	togekiss	en-AU	
t	togepi	en-AU	
bst	toridepusu	en-AU	
gas	toritodon	en-AU	
torn	tornadus	en-AU	
ty	tornupto	en-AU	
ck	toroggon	en-AU	
tro	toropiusu	en-AU	
bla	tortank	en-AU	
tur	tortipouss	en-AU	
gd	tosakinto	en-AU	
sun	tournegrin	en-AU	
gos	tournicoton	en-AU	
grv	toutombe	en-AU	
to	toxapex 	en-AU	
tox	toxiquak	en-AU	
tx	toxizap	en-AU	
cub	tragosso	en-AU	
r	trasla	en-AU	
dro	traumato	en-AU	
mum	traunfugil	en-AU	
mis	traunmagil	en-AU	
wgg	triopikeau	en-AU	
dug	triopikeur	en-AU	
hyd	trioxhydre	en-AU	
ohr	trombork	en-AU	
fo	trompignon	en-AU	
cf	trousselin	en-AU	
shu	tsubotsubo	en-AU	
stak	tsundetsunde	en-AU	
cof	tutankafer	en-AU	
nin	tutinin	en-AU	
alt	tyltalis	en-AU	
w	tyltto	en-AU	
0	typ:Null	en-AU	
all	tyracroc 	en-AU	
onv	uhafnir	en-AU	
wee	ultrigaria	en-AU	
av	uochirudon	en-AU	
dv	uonoragon	en-AU	
urs	urshifu	en-AU	
px	urugamosu	en-AU	
bon	usohachi	en-AU	
ux	uxie	en-AU	
crad	vacilys	en-AU	
skr	venalgue	en-AU	
fs	venipatte	en-AU	
mus	venuflibis 	en-AU	
vib	vibraninf 	en-AU	
v	victini	en-AU	
bmb	virevorreur 	en-AU	
bm	virovent	en-AU	
fr	viskuse	en-AU	
dee	vivaldaim	en-AU	
volc	volcanion	en-AU	
magc	volcaropod	en-AU	
mane	voltenso	en-AU	
mar	voltilamm	en-AU	
yam	voltoutou	en-AU	
pro	voluminas	en-AU	
vu	vostourno	en-AU	
nine	vulnona	en-AU	
com	wakasyamo	en-AU	
bra	washakwil	en-AU	
eld	watashiraga	en-AU	
jol	wattzapf	en-AU	
wail	whaloh	en-AU	
fu	wiesenior	en-AU	
ind	wimessir	en-AU	
ar	windie 	en-AU	
wc	wo-chien	en-AU	
wo	woingenau	en-AU	
ly	wolwerock	en-AU	
hap	wonneira	en-AU	
xx	xerneas	en-AU	
xu	xurkitree	en-AU	
mur	yamikarasu	en-AU	
sab	yamirami	en-AU	
yan	yanyanma	en-AU	
vi	yarukimono	en-AU	
pup	ymphect	en-AU	
gre	yokubarisu	en-AU	
yk	yorkleff 	en-AU	
noc	yorunozuku	en-AU	
sno	yukikaburi	en-AU	
fros	yukimenoko	en-AU	
sn	yukiwarashi	en-AU	
ka	yungerer	en-AU	
yy	yveltal	en-AU	
zac	zacian	en-AU	
zam	zamazenta	en-AU	
zap	zapdos	en-AU	
wt	zapetrel	en-AU	
eel	zapplalek	en-AU	
zar	zarude	en-AU	
zeb	zebritz	en-AU	
zek	zekrom	en-AU	
sq	zenigame	en-AU	
zer	zeraora	en-AU	
kric	zirpeise	en-AU	
zz	zoroaku	en-AU	
zo	zorua	en-AU	
cd	zugaidos	en-AU	
yo	zwirrfinst	en-AU	
dusc	zwirrklop	en-AU	
dc	zwirrklop 	en-AU	
du	zwirrlicht	en-AU	
de	zwottronin	en-AU	
zy	zygarde	en-AU	
reu	zytomega	en-AU	
mlk	écrémeuh	en-AU	
ele	élektek	en-AU	
